0,0,0,0,0,0,0,0,0,0,0,0,0,0,0,0,0,0,0,0,0,0,0,0,0,0,0,0,0,0,0,0,0,0,0,0,0,0,0,0,0
0,0,0,0,0,0,0,0,0,0,0,0,0,0,0,0,0,0,0,0,0,0,0,0,0,0,0,0,0,0,0,0,0,0,0,0,0,0,0,0,0
0,0,0,0,0,0,0,0,0,0,0,0,0,0,0,0,0,4,4,4,4,4,4,4,0,0,0,0,0,0,0,0,0,0,0,0,0,0,0,0,0
0,0,0,0,0,0,0,0,0,0,0,0,0,0,0,0,0,4,4,4,T_HP->-1,4,4,4,0,0,0,0,0,0,0,0,0,0,0,0,0,0,0,0,0
0,0,0,0,0,0,0,0,0,0,0,0,0,0,0,0,0,4,4,4,4,4,4,4,0,0,0,0,0,0,0,0,0,0,0,0,0,0,0,0,0
0,0,0,0,0,0,0,0,0,0,0,0,0,0,0,0,0,4,4,4,4,4,4,4,0,0,0,0,0,0,0,0,0,0,0,0,0,0,0,0,0
0,0,0,0,0,0,0,0,0,0,0,0,0,0,0,0,0,4,4,4,4,4,4,4,0,0,0,0,0,0,0,0,0,0,0,0,0,0,0,0,0
0,0,0.5,0.5,0.5,0.5,0.5,0.5,0.5,0.5,0.5,0.5,0.5,0.5,0.5,0.5,0.5,T,T,T,T,T,T,T,0.5,0.5,0.5,0.5,0.5,0.5,0.5,0.5,0.5,0.5,0.5,0.5,0.5,0.5,0.5,0,0
0,0,T,T,T,T,T,T,T,T,T,T,T,T,T,T,T,T,T,T,T,T,T,T,T,T,T,T,T,T,T,T,T,T,T,T,T,T,T,0,0
0,0,T,T,T,T,T,T,T,T,T,T,T,T,T,T,T,T,T,T,T,T,T,T,T,T,T,T,T,T,T,T,T,T,T,T,T,T,T,0,0
0,0,T,T,T,T,T,T,T,T,T,T,T,T,T,T,T,T,T,T,T,T,T,T,T,T,T,T,T,T,T,T,T,T,T,T,T,T,T,0,0
0,0,T,T,T,T,T,T,T,T,T,T,T,T,T,T,T,T,T,T,T,T,T,T,T,T,T,T,T,T,T,T,T,T,T,T,T,T,T,0,0
0,0,T,T,T,T,T,T,T,T,T,T,T,T,T,T,T,T,T,T,T,T,T,T,T,T,T,T,T,T,T,T,T,T,T,T,T,T,T,0,0
0,0,T,T,T,T,T_B2->T__3,T,T,T,T,T,T,T,T,T,T,T,T,T,T__3->T_HP,T,T,T,T,T,T,T,T,T,T,T,T,T,T_A2->T__3,T,T,T,T,0,0
0,0,T,T,T,T,T,T,T,T,T,T,T,T,T,T,T,T,T,T,T,T,T,T,T,T,T,T,T,T,T,T,T,T,T,T,T,T,T,0,0
0,0,T,T,T,T,T,T,T,T,T,T,T,T,T,T,T,T,T,T,T,T,T,T,T,T,T,T,T,T,T,T,T,T,T,T,T,T,T,0,0
0,0,T,T,T,T,T,T,T,T,T,T,T,T,T,T,T,T,T,T,T,T,T,T,T,T,T,T,T,T,T,T,T,T,T,T,T,T,T,0,0
0,0,T,T,T,T,T,T,T,T,T,T,T,T,T,T,T,T,T,T,T_FP,T,T,T,T,T,T,T,T,T,T,T,T,T,T,T,T,T,T,0,0
0,0,T,T,T,T,T,T,T,T,T,0,0,0,0,0,0,0,0,0,0,0,0,0,0,0,0,0,0,0,T,T,T,T,T,T,T,T,T,0,0
0,0,T,T,T,T,T,T,T,T,T,0,0,0,0,0,0,0,0,0,0,0,0,0,0,0,0,0,0,0,T,T,T,T,T,T,T,T,T,0,0
0,0,T,T,T,T,T,T,T,T,T,0,0,0,0,0,0,0,0,0,0,0,0,0,0,0,0,0,0,0,T,T,T,T,T,T,T,T,T,0,0
0,0,T,T,T,T,T,T,T,T,T,0,0,0,0,0,0,0,0,0,0,0,0,0,0,0,0,0,0,0,T,T,T,T,T,T,T,T,T,0,0
0,0,T,T,T,T,T,T,T,T,T,0,0,0,0,0,0,0,0,0,0,0,0,0,0,0,0,0,0,0,T,T,T,T,T,T,T,T,T,0,0
0,0,T,T,T,T,T,T,T,T,T,0,0,0,0,0,0,0,0,0,0,0,0,0,0,0,0,0,0,0,T,T,T,T,T,T,T,T,T,0,0
0,0,T,T,T,T,T,T,T,T,T,0,0,0,0,0,0,0,0,0,0,0,0,0,0,0,0,0,0,0,T,T,T,T,T,T,T,T,T,0,0
0,0,T,T,T,T,T,T,T,T,T,0,0,0,0,0,0,0,0,0,0,0,0,0,0,0,0,0,0,0,T,T,T,T,T,T,T,T,T,0,0
0,0,T,T,T,T,T,T,T,T,T,0.5,0.5,0.5,0.5,0.5,0.5,0.5,0.5,0.5,0,0.5,0.5,0.5,0.5,0.5,0.5,0.5,0.5,0.5,T,T,T,T,T,T,T,T,T,0,0
0,0,4,4,4,4,4,4,4,4,4,4,4,4,4,4,4,4,4,4,0,4,4,4,4,4,4,4,4,4,4,4,4,4,4,4,4,4,4,0,0
0,0,4,4,4,4,4,4,4,4,4,4,4,4,4,4,4,4,4,4,0,4,4,4,4,4,4,4,4,4,4,4,4,4,4,4,4,4,4,0,0
0,0,4,4,4,4,4,4,4,4,4,4,4,4,4,4,4,4,4,4,0,4,4,4,4,4,4,4,4,4,4,4,4,4,4,4,4,4,4,0,0
0,0,4,4,4,4,T_B1->T_B2,4,4,4,4,4,4,4,4,4,4,4,4,T_B0->T_B1,0.5,T_A0->T_A1,4,4,4,4,4,4,4,4,4,4,4,4,T_A1->T_A2,4,4,4,4,0,0
0,0,0.5,0.5,0.5,0.5,0.5,0.5,0.5,0.5,0.5,0.5,0.5,0.5,0.5,0.5,0.5,0.5,0.5,0.5,6,0.5,0.5,0.5,0.5,0.5,0.5,0.5,0.5,0.5,0.5,0.5,0.5,0.5,0.5,0.5,0.5,0.5,0.5,0,0
0,0,4,4,4,4,B_B1->B_B2,4,4,4,4,4,4,4,4,4,4,4,4,B_B0->B_B1,0,B_A0->B_A1,4,4,4,4,4,4,4,4,4,4,4,4,B_A1->B_A2,4,4,4,4,0,0
0,0,4,4,4,4,4,4,4,4,4,4,4,4,4,4,4,4,4,4,0,4,4,4,4,4,4,4,4,4,4,4,4,4,4,4,4,4,4,0,0
0,0,4,4,4,4,4,4,4,4,4,4,4,4,4,4,4,4,4,4,0,4,4,4,4,4,4,4,4,4,4,4,4,4,4,4,4,4,4,0,0
0,0,4,4,4,4,4,4,4,4,4,4,4,4,4,4,4,4,4,4,0,4,4,4,4,4,4,4,4,4,4,4,4,4,4,4,4,4,4,0,0
0,0,B,B,B,B,B,B,B,B,B,0,0,0,0,0,0,0,0,0,0,0,0,0,0,0,0,0,0,0,B,B,B,B,B,B,B,B,B,0,0
0,0,B,B,B,B,B,B,B,B,B,0,0,0,0,0,0,0,0,0,0,0,0,0,0,0,0,0,0,0,B,B,B,B,B,B,B,B,B,0,0
0,0,B,B,B,B,B,B,B,B,B,0,0,0,0,0,0,0,0,0,0,0,0,0,0,0,0,0,0,0,B,B,B,B,B,B,B,B,B,0,0
0,0,B,B,B,B,B,B,B,B,B,0,0,0,0,0,0,0,0,0,0,0,0,0,0,0,0,0,0,0,B,B,B,B,B,B,B,B,B,0,0
0,0,B,B,B,B,B,B,B,B,B,0,0,0,0,0,0,0,0,0,0,0,0,0,0,0,0,0,0,0,B,B,B,B,B,B,B,B,B,0,0
0,0,B,B,B,B,B,B,B,B,B,0,0,0,0,0,0,0,0,0,0,0,0,0,0,0,0,0,0,0,B,B,B,B,B,B,B,B,B,0,0
0,0,B,B,B,B,B,B,B,B,B,0,0,0,0,0,0,0,0,0,0,0,0,0,0,0,0,0,0,0,B,B,B,B,B,B,B,B,B,0,0
0,0,B,B,B,B,B,B,B,B,B,0,0,0,0,0,0,0,0,0,0,0,0,0,0,0,0,0,0,0,B,B,B,B,B,B,B,B,B,0,0
0,0,B,B,B,B,B,B,B,B,B,0.5,0.5,0.5,0.5,0.5,0.5,0.5,0.5,0.5,0.5,0.5,0.5,0.5,0.5,0.5,0.5,0.5,0.5,0.5,B,B,B,B,B,B,B,B,B,0,0
0,0,B,B,B,B,B,B,B,B,B,B,B,B,B,B,B,B,B,B,B,B,B,B,B,B,B,B,B,B,B,B,B,B,B,B,B,B,B,0,0
0,0,B,B,B,B,B,B,B,B,B,B,B,B,B,B,B,B,B,B,B,B,B,B,B,B,B,B,B,B,B,B,B,B,B,B,B,B,B,0,0
0,0,B,B,B,B,B,B,B,B,B,B,B,B,B,B,B,B,B,B,B,B,B,B,B,B,B,B,B,B,B,B,B,B,B,B,B,B,B,0,0
0,0,B,B,B,B,B,B,B,B,B,B,B,B,B,B,B,B,B,B,B,B,B,B,B,B,B,B,B,B,B,B,B,B,B,B,B,B,B,0,0
0,0,B,B,B,B,B,B,B,B,B,B,B,B,B,B,B,B,B,B,B,B,B,B,B,B,B,B,B,B,B,B,B,B,B,B,B,B,B,0,0
0,0,B,B,B,B,B_B2->B__3,B,B,B,B,B,B,B,B,B,B,B,B,B,B__3->B_HP,B,B,B,B,B,B,B,B,B,B,B,B,B,B_A2->B__3,B,B,B,B,0,0
0,0,B,B,B,B,B,B,B,B,B,B,B,B,B,B,B,B,B,B,B,B,B,B,B,B,B,B,B,B,B,B,B,B,B,B,B,B,B,0,0
0,0,B,B,B,B,B,B,B,B,B,B,B,B,B,B,B,B,B,B,B,B,B,B,B,B,B,B,B,B,B,B,B,B,B,B,B,B,B,0,0
0,0,B,B,B,B,B,B,B,B,B,B,B,B,B,B,B,B,B,B,B_FP,B,B,B,B,B,B,B,B,B,B,B,B,B,B,B,B,B,B,0,0
0,0,B,B,B,B,B,B,B,B,B,B,B,B,B,B,B,B,B,B,B,B,B,B,B,B,B,B,B,B,B,B,B,B,B,B,B,B,B,0,0
0,0,B,B,B,B,B,B,B,B,B,B,B,B,B,B,B,B,B,B,B,B,B,B,B,B,B,B,B,B,B,B,B,B,B,B,B,B,B,0,0
0,0,0,0,0,0,0,0,0,0,0,0,0,0,0,0,0,B,B,B,B,B,B,B,0,0,0,0,0,0,0,0,0,0,0,0,0,0,0,0,0
0,0,0,0,0,0,0,0,0,0,0,0,0,0,0,0,0,4,4,4,4,4,4,4,0,0,0,0,0,0,0,0,0,0,0,0,0,0,0,0,0
0,0,0,0,0,0,0,0,0,0,0,0,0,0,0,0,0,4,4,4,4,4,4,4,0,0,0,0,0,0,0,0,0,0,0,0,0,0,0,0,0
0,0,0,0,0,0,0,0,0,0,0,0,0,0,0,0,0,4,4,4,4,4,4,4,0,0,0,0,0,0,0,0,0,0,0,0,0,0,0,0,0
0,0,0,0,0,0,0,0,0,0,0,0,0,0,0,0,0,4,4,4,B_HP->-1,4,4,4,0,0,0,0,0,0,0,0,0,0,0,0,0,0,0,0,0
0,0,0,0,0,0,0,0,0,0,0,0,0,0,0,0,0,4,4,4,4,4,4,4,0,0,0,0,0,0,0,0,0,0,0,0,0,0,0,0,0
0,0,0,0,0,0,0,0,0,0,0,0,0,0,0,0,0,0,0,0,0,0,0,0,0,0,0,0,0,0,0,0,0,0,0,0,0,0,0,0,0
0,0,0,0,0,0,0,0,0,0,0,0,0,0,0,0,0,0,0,0,0,0,0,0,0,0,0,0,0,0,0,0,0,0,0,0,0,0,0,0,0